NO ./textures/north_wall.xpm
SO ./textures/south_wall.xpm
WE ./textures/west_wall.xpm
EA ./textures/east_wall.xpm

F 128,128,128
C 0,255,255




11111111111
111110000001
10100000011
10001110001
10N0000001
1000111111
1000111111
1111111111


