NO ./textures/north_wall.xpm
SO ./textures/south_wall.xpm
WE ./textures/west_wall.xpm
EA ./textures/east_wall.xpm

F 128,128,128
C 0,255,255


11111 
11N11 
11111 
  1
  1
1111
1001
1011
