NO ./textures/north_wall.xpm
SO ./textures/south_wall.xpm
WE ./textures/west_wall.xpm
EA ./textures/east_wall.xpm

F 128,128,128
C 0,255,255


//111
//1N1
//111

11111111111
111110000001
10000000011
1011110001
1000000001
10W0111111
1000111111
1111111111
