NO ./textures/north_wall.xpm
SO ./textures/south_wall.xpm
WE ./textures/west_wall.xpm
EA ./textures/east_wall.xpm

F 128,128,128
C 0,255,255


11111 111
11N11 101
11111 111
