NO ./textures/wall1.xpm
SO ./textures/wall.xpm
WE ./textures/wall.xpm
EA ./textures/wall.xpm

F 128,128,128
C 0,255,255


//111
//1N1
//111

1111111111
1111100001
1000000001
1011110001
1000000001
10W0111111
1000111111
1111111111
