NO ./textures/wall1.xpm
SO ./textures/wall.xpm
WE ./textures/wall.xpm
EA ./textures/wall.xpm

F 128,128,128
C 0,255,255

11111
10001
10111
10001
10W01
10001
11111
